........................................................................................................................................................................................................................................
........................................................................................................................................................................................................................................
........................................................................................................................................................................................................................................
........................................................................................................................................................................................................................................
........................................................................................................................................................................................................................................
........................................................................................................................................................................................................................................
................................M_R00C01M_R00C02........M_R03C07........................................................................................................................................................................
........JJJJJJJJ................................M_R03C06M_R03C09M_R03C08................................................................................................................................................................
........M_R18C09................................M_R03C03M_R03C04M_R03C05........................M_R00C01M_R00C02........................................M_R03C07........................................MCR15C08MCR09C09MCR09C09MCR11C04
MCR09C09MCR19C03................................M_R02C01M_R02C02M_R02C00........................................................................M_R03C06M_R03C09M_R03C08................................MCR14C09MCR07C00MCR06C02MCR06C02
MCR06C03MCR14C08........M_R02C03........................M_R02C04................................................................................M_R03C03M_R03C04M_R03C05........M_R00C01M_R00C02........MCR14C09MCR07C03MCR06C02MCR06C02
MCR06C03MCR11C06MCR09C09MCR09C09MCR09C09MCR09C09MCR09C09MCR09C09MCR09C09MCR09C09MCR09C09MCR11C08M_R18C08................M_R00C01M_R00C02........M_R02C01M_R02C02M_R02C00................................MCR14C09MCR06C02MCR06C02MCR06C02
M_R06C04M_R06C03M_R06C02M_R07C03M_R06C02M_R06C02M_R07C01M_R06C03M_R06C02M_R06C03M_R06C03M_R11C06MCR19C03................................M_R04C04M_R05C04M_R02C05M_R04C04M_R00C04........................MCR14C09M_R06C03M_R07C01MCR06C03
M_R09C05M_R09C06M_R07C03M_R06C02M_R06C02M_R06C02M_R07C01M_R06C02M_R06C02M_R06C02M_R06C02M_R06C02MCR11C06MCR11C08M_R18C09........M_R01C02MCR02C06MCR02C07MCR03C01MCR02C07MCR02C07MCR02C09................MCR14C09M_R07C00M_R06C02MCR06C02
M_R10C05M_R10C06M_R06C02M_R06C02M_R06C02M_R06C02M_R06C02M_R06C02M_R06C02M_R06C02M_R06C02M_R07C02M_R06C02MCR11C06MCR19C03........M_R01C01................M_R02C05........................................MCR14C09M_R07C03M_R06C02MCR06C02
M_R06C04M_R06C03M_R06C02M_R07C03M_R06C02M_R06C02M_R07C01M_R06C03M_R06C02M_R06C03M_R06C02M_R06C02M_R06C02MCR06C02MCR11C06MCR11C08M_R05C01................M_R02C04M_R18C09M_R18C08........................MCR14C09M_R06C02M_R06C02MCR06C02
M_R06C04M_R06C03M_R06C02M_R07C03M_R06C02M_R06C02M_R07C01M_R06C03M_R06C02M_R06C03M_R06C02M_R06C02M_R06C02M_R06C02MCR07C03MCR11C06MCR06C01MCR09C09MCR09C09MCR09C09MCR09C09MCR09C09MCR09C09MCR09C09MCR09C09MCR11C04M_R06C03M_R06C02MCR07C02