







                                                                                                                                                                                                        MCR15C08MCR09C09MCR09C09MCR11C04
MCR09C09MCR11C08                                                                                                                                                                                        MCR14C09MCR07C00MCR06C02MCR06C04
MCR06C03MCR14C08                                                                                                                                                                                        MCR14C09MCR07C03MCR06C02MCR06C02
MCR06C03MCR11C06MCR09C09MCR09C09MCR09C09MCR09C09MCR09C09MCR09C09MCR09C09MCR09C09MCR09C09MCR11C08                                                                                                        MCR14C09MCR06C02MCR06C02MCR06C02
MCR06C04MCR06C03MCR06C02MCR07C03MCR06C02MCR06C02MCR07C01MCR06C03MCR06C02MCR06C03MCR06C03MCR11C06MCR11C08                                                                                                MCR14C09MCR06C02MCR07C01MCR06C03
MCR09C05MCR09C06MCR07C03MCR06C02MCR06C02MCR06C02MCR07C01MCR06C02MCR06C02MCR06C02MCR06C02MCR06C02MCR11C06MCR11C08                                                                                        MCR14C09MCR06C03MCR06C02MCR06C02
MCR10C05MCR10C06MCR06C02MCR06C02MCR06C02MCR06C02MCR06C02MCR06C02MCR06C02MCR06C02MCR06C02MCR07C02MCR06C02MCR11C06MCR11C08                                                                                MCR14C09MCR07C00MCR06C02MCR06C02
MCR06C04MCR06C03MCR06C02MCR07C03MCR06C02MCR06C02MCR07C01MCR06C03MCR06C02MCR06C03MCR06C03MCR11C06MCR06C02MCR06C02MCR11C06MCR11C08                                                                        MCR14C09MCR06C02MCR06C02MCR06C02
MCR06C04MCR06C03MCR06C02MCR07C03MCR06C02MCR06C02MCR07C01MCR06C03MCR06C02MCR06C03MCR06C03MCR11C06MCR06C02MCR06C02MCR07C03MCR11C06MCR06C01MCR09C09MCR09C09MCR09C09MCR09C09MCR09C09MCR09C09MCR09C09MCR09C09MCR11C04MCR06C03MCR06C02MCR07C02