F1F1F1F1F1F1F1F1F1F1F1F1F1F1F1F1F1F1F1F1F1F1F1F1F1F1F1F1F1F1F1F1F1F1F1F1F1F1F1F1F1F1F1F1F1F1F1F1F1F1F1F1F1F1F1F1F1F1F1F1F1F1F1F1F1F1F1F1F1F1F1F1F1F1F1F1F1F1F1F1F1F1F1F1F1F1F1F1F1F1F1F1F1F1F1F1F1F1F1F1F1F1F1F1F1F1F1F1F1F1F1F1F1F1F1F1F1F1F1F1F1F1F1F1F1F1F1F1F1F1F1F1F1F1F1F1F1F1F1F1F1F1F1F1F1F1F1F1F1F1F1F1F1F1F1F1F1F1F1F1F1F1F1F1F1F1F1F1F1F1F1F1F1F1F1F1F1F1F1F1F1F1F1F1F1F1F1F1F1F1F1F1F1F1F1F1F1F1F1F1F1F1F1F1F1F1F1F1F1F1F1F1F1F1F1F1F1F1F1F1F1F1F1F1F1F1F1F1F1F1F1F1F1F1F1F1F1F1F1F1F1F1F1F1F1F1
          F1F1F1F1F1F1F1F1F1F1F1F1F1F1F1F1F1F1F1F1F1F1F1F1C1                                C2F1F1F1                                                            F1F1F1F1F1F1F1F1F1F1F1F1                                                              F1                    F1F1F1F1F1F1F1F1F1F1F1F1F1F1F1F1F1F1                                                                                    R1                                                                                  F1F1F1F1F1F1F1F1F1F1
          F1F1F1F1F1F1F1F1F1F1F1F1F1F1F1F1F1F1F1F1F1F1F1C1                                    C2F1F1                                                            F1F1F1F1F1F1F1F1F1F1F1F1                                                              F1                    F1F1F1F1F1F1F1F1F1F1F1F1F1F1F1F1F1F1                                                                                      R1                                T1T1T1T1T1T1T1T1T1T1T1T1T1T1T1T1T1T1T1T1R1      R1F1F1F1F1F1F1F1F1F1
          F1F1F1F1F1F1F1F1F1F1F1F1F1F1C1  C2F1F1F1F1F1C1                                        C2F1R1                                                          F1F1F1F1F1F1F1F1F1F1F1F1                                                              F1                    F1F1F1F1F1F1F1F1F1F1F1F1F1F1F1F1F1F1                                                                                        R1                            R2                                        F1R1      R1F1F1F1F1F1F1F1F1    
          C2F1F1F1F1F1F1F1F1F1F1F1F1C1      C2F1F1F1C1                                            C2F1R1                                                        F1F1F1F1F1F1F1F1F1F1F1F1                                                              F1                    F1F1F1F1F1F1F1F1F1F1F1F1F1F1F1F1F1F1                                                                                          R1                        R2                                                      R1F1F1F1F1F1F1F1
                      C2F1F1F1F1F1C1                                                                C2F1F1        T1R1                                          F1F1F1F1F1F1F1F1F1F1F1F1                                                              F1                    F1F1F1F1F1F1F1F1F1F1F1F1F1F1F1F1F1F1                                                                                            R1                    R2                                            T1T1T1R1      R1F1F1F1F1F1F1  
                        C2F1F1F1C1                      JJ                                            C2F1T1T1T1T1T1F1                                          F1F1F1F1F1F1F1F1F1F1F1F1                                                              F1                    F1F1F1F1F1F1F1F1F1F1F1F1F1F1F1F1F1F1                                                                                              R1                R2                                              F1      R1      R1F1F1F1F1F1    
                                                      R2T1R1                                            C2F1F1F1F1F1F1                                          F1F1F1F1F1F1F1F1F1F1F1F1                                                              F1                    F1F1F1F1F1F1F1F1F1F1F1F1F1F1F1F1F1F1                                                                                                R1            R2                                                F1        R1      R1F1F1F1F1
                                                    R2F0F1F6R1              R2T1T1T1T1                    C2F1F1F1F1F1                                          F1F1F1F1F1F1F1F1F1F1F1F1                                                              F1                    F1F1F1F1F1F1F1F1F1F1F1F1F1F1F1F1F1F1                                                                                                  R1        R2                                                  F1          R1      R1F1F1F1
                                                  R2F0F1F1F1F6R1          R2F0F1F1F1F1                        F1F1F1F1                                                                                                                                F1                    F1F1F1F1F1F1F1F1F1F1F1F1F1F1F1F1F1F1                                                                                                    F1F1F1F1                                                    F1            R1      R1F1F1
                                                R2F0F1F1F1F1F1F6R1      R2F0F1F1F1F1F1                        F1F1F1F1                                            T1T1T1T1T1T1T1T1T1T1T1T1T1T1T1T1T1T1T1T1T1T1T1                                      F1                    F1F1F1F1F1F1F1F1F1F1F1F1F1F1F1F1F1F1                                                                                                                                                                F1F1F1F1F1F1F1  R1      R1F1
                                            T1T1T1F1F1F1F1F1F1F1F1T1T1T1F1F1F1F1F1F1T1T1T1T1T1                F1F1F1T1                                                                                        F1                                      R2                    F1F1F1F1F1F1F1F1F1F1F1F1F1F1F1F1F1F1                                                                                                                                                                              R1F1R1      F1
T1R1                                        F1F1F1F1F1F1F1F1F1F1F1F1F1F1F1F1F1F1F1F1F1F1F1F1T1T1T1T1T1R1      F1F1F1F1                                                                                        F1                                    R2                      F1F1F1F1F1F1F1F1F1F1F1F1F1F1F1F1F1F1                                                                                                    T1T1T1                                                                    R2    R1    F1
F1F1                                        F1F1F1F1F1F1F1F1F1F1F1F1F1F1F1F1F1F1F1F1F1F1F1F1F1F1F1F1F1F1      F1F1F1F1                                                                                        F1        F1F1F1F1F1F1F1F1F1R2                                F1F1F1F1F1F1F1F1F1F1F1F1F1F1F1F1F1F1                                                                                                                                                                T1T1T1T1T1T1T1T1T1T1T1T1T1T1
F1F1T1T1T1T1T1T1T1R1                        F1F1F1F1F1F1F1F1F1F1F1F1F1F1F1F1F1F1F1F1F1F1F1F1F1F1F1F1F1F1      F1F1F1F1                                                                                        F1    F1F1                                                    F1F1F1F1F1F1F1F1F1F1F1F1F1F1F1F1F1F1                                                                                                  T1T1T1T1T1                                                    F1F1F1F1F1F1F1F1F1F1F1F1F1F1
F1F1F1F1F1F1F1F1F1F6R1                      F1F1F1F1F1F1F1F1F1F1F1F1F1F1F1F1F1F1F1F1F1F1F1F1F1F1F1F1F1F1      F1F1F1F1                                                                                        F1F1F1F1F1                                                    F1F1F1F1F1F1F1F1F1F1F1F1F1F1F1F1F1F1                                                                                                                                                                F1F1F1F1F1F1F1F1F1F1F1F1F1F1
F1F1F1F1F1F1F1F1F1F1F6R1                    F1F1F1F1F1F1F1F1F1F1F1F1F1F1F1F1F1F1F1F1F1F1F1F1F1F1F1F1F1C1      C2F1F1F1                                                                                                                            T1T1T1                    F1F1F1F1F1F1F1F1F1F1F1F1F1F1F1F1F1F1                                                                                            T1T1T1T1T1T1T1T1T1T1                                                F1F1F1F1F1F1F1F1F1F1F1F1F1F1
F1F1F1F1F1F1F1F1F1F1F1F6R1                  F1F1F1F1F1F1F1F1F1F1F1F1F1F1F1F1F1F1                                                                                                                                                                  F1F1F1                          C2F1F1F1F1F1F1F1F1F1F1F1F1F1F1                                                                                                                                      T1T1T1T1                  F1F1F1F1F1F1F1F1F1F1F1F1F1F1
F1F1F1F1F1F1F1F1F1F1F1F1T1T1T1T1T1T1T1T1T1T1T1F1F1F1F1F1F1F1F1F1F1F1F1F1                                                                                    R2T1T1T1T1T1T1T1F1F1F1F1F1T1T1T1T1F1F1F1F1F1T1T1T1T1T1T1T1T1T1T1T1T1T1T1T1T1T1T1T1T1T1T1F1T1T1T1T1T1T1T1T1T1T1T1T1R1    C2F1F1F1F1F1F1F1F1F1F1F1F1F1                                                                                          R2T1T1T1T1T1T1T1T1T1T1T1R1                    F1F1                    F1F1F1F1F1F1F1F1F1F1F1F1F1F1
F1F1F1F1F1F1F1F1F1F1F1F1F1F1F1F1F1F1F1F1F1F1F1F1F1F1F1F1F1F1F1F1F1                                  R2T1T1T1T1T1R1                                R2T1T1T1T1F1F1F1F1F1F1F1                                        F1F1F1F1F1F1F1F1F1F1F1F1F1F1F1F1F1F1F1F1F1F1F1F1F1F1F1F1F1F1F6R1    C2F1F1F1F1F1F1F1F1F1F1F1F1                                                                                        R2F1F1F1F1F1F1F1F1F1F1F1F1F1R1                  F1F1        F1          F1F1F1F1F1F1F1F1F1F1F1F1F1F1
F1F1F1F1F1F1F1F1F1F1F1F1F1F1F1F1F1F1F1F1F1F1F1F1F1F1F1F1F1F1F1F1F1  T1T1T1T1T1T1                  R2F0F1F1F1F1F1F6R1        T1T1          R2T1T1T1F1F1F1F1F1F1F1F1F1F1F1F1                                        F1F1F1F1F1F1F1F1F1F1F1F1F1F1F1F1F1F1F1F1F1F1F1F1F1F1F1F1F1F1F1F6R1    C2F1F1F1F1F1F1F1F1F1F1F1                                                                                      R2F1F1F1F1F1F1F1F1F1F1F1F1F1F1T1T1F1F1F1F1F1F1T1T1F1F1T1T1T1T1T1T1T1T1T1T1F1F1F1F1F1F1F1F1F1F1F1F1F1F1
F1F1F1F1F1F1F1F1F1F1F1F1F1F1F1F1F1F1F1F1F1F1F1F1F1F1F1F1F1F1F1F1F1  F1F1F1F1F1F1                R2F0F1F1F1F1F1F1F1F6R1              R2T1T1F1F1F1F1F1F1F1F1F1F1F1F1F1F1F1F1                                        F1F1F1F1F1F1F1F1F1F1F1F1F1F1F1F1F1F1F1F1F1F1F1F1F1F1F1F1F1F1F1F1F6R1    C2F1F1F1F1F1F1F1F1F1F1                                                                              T1T1T1T1F1F1F1F1F1F1F1F1F1F1F1F1F1F1F1F1F1F1F1F1F1F1F1F1F1F1F1F1F1F1F1F1F1F1F1F1F1F1F1F1F1F1F1F1F1F1F1F1F1F1F1
F1F1F1F1F1F1F1F1F1F1F1F1F1F1F1F1F1F1F1F1F1F1F1F1F1F1F1F1F1F1F1F1F1  F1F1F1F1F1T1T1T1T1T1T1T1T1T1T1F1F1F1F1F1F1F1F1F1F6R1            F1F1F1F1F1F1F1F1F1F1F1F1F1F1F1F1F1F1F1                                        F1F1F1F1F1F1F1F1F1F1F1F1F1F1F1F1F1F1F1F1F1F1F1F1F1F1F1F1F1F1F1F1F1F6R1    C2F1F1F1F1F1F1F1F1C1                                                                          T1T1T1F1F1F1F1F1F1F1F1F1F1F1F1F1F1F1F1F1F1F1F1F1F1F1F1F1F1F1F1F1F1F1F1F1F1F1F1F1F1F1F1F1F1F1F1F1F1F1F1F1F1F1F1F1F1
F1F1F1F1F1F1F1F1F1F1F1F1F1F1F1F1F1F1F1F1F1F1F1F1F1F1F1F1F1F1F1F1F1              F1F1F1F1F1F1F1F1F1F1F1F1F1F1F1F1F1F1F1T1F1F1F1F1F1F1F1F1F1F1F1F1F1F1F1F1F1F1F1F1F1F1F1F1F1                                        F1F1F1F1F1F1F1F1F1F1F1F1F1F1F1F1F1F1F1F1F1F1F1F1F1F1F1F1F1F1F1F1F1F1F6R1    C2F1F1F1F1F1F1C1                                                                          T1T1T1F1F1F1F1F1F1F1F1F1F1F1F1F1F1F1F1F1F1F1F1F1F1F1F1F1F1F1F1F1F1F1F1F1F1F1F1F1F1F1F1F1F1F1F1F1F1F1F1F1F1F1F1F1F1F1
F1F1F1F1F1F1F1F1F1F1F1F1F1F1F1F1F1F1F1F1F1F1F1F1F1F1F1F1F1F1F1F1F1                                                                                                                                                F1F1F1F1F1F1F1F1F1F1F1F1F1F1F1F1F1F1F1F1F1F1F1F1F1F1F1F1F1F1F1F1F1F1F1F6R1    C2F1F1F1F1C1    R2T1T1T1T1T1T1T1R1                                                        R2F1F1F1F1F1F1F1F1F1F1F1F1F1F1F1F1F1F1F1F1F1F1F1F1F1F1F1F1F1F1F1F1F1F1F1F1F1F1F1F1F1F1F1F1F1F1F1F1F1F1F1F1F1F1F1F1
F1F1F1F1F1F1F1F1F1F1F1F1F1F1F1F1F1F1F1F1F1F1F1F1F1F1F1F1F1F1F1F1F1                                                                                  R2T1T1T1T1T1T1T1T1T1T1T1T1T1T1T1T1T1T1T1T1T1T1T1T1T1T1T1T1T1T1T1T1F1F1F1F1F1F1F1F1F1F1F1F1F1F1F1F1F1F1F1F1F1F1F1F1F1F1F1F1F1F1F1F1F1F1F6R1    C2F1F1C1    R2F0F1F1F1F1F1F1F1F6R1                                                    R2F1F1F1F1F1F1F1F1F1F1F1F1F1F1F1F1F1F1F1F1F1F1F1F1F1F1F1F1F1F1F1F1F1F1F1F1F1F1F1F1F1F1F1F1F1F1F1F1F1F1F1F1F1F1F1F1F1
F1F1F1F1F1F1F1F1F1F1F1F1F1F1F1F1F1F1F1F1F1F1F1F1F1F1F1F1F1F1F1T1T1T1T1T1T1T1T1T1T1                                                                R2F0F1F1F1F1F1F1F1F1F1F1F1F1F1F1F1F1F1F1F1F1F1F1F1F1F1F1F1F1F1F1F1F1F1F1F1F1F1F1F1F1F1F1F1F1F1F1F1F1F1F1F1F1F1F1F1F1F1F1F1F1F1F1F1F1F1F1F1F6R1    C2C1    R2F0F1F1F1F1F1F1F1F1F1F6R1                                                R2F1F1F1F1F1F1F1F1F1F1F1F1F1F1F1F1F1F1F1F1F1F1F1F1F1F1F1F1F1F1F1F1F1F1F1F1F1F1F1F1F1F1F1F1F1F1F1F1F1F1F1F1F1F1F1F1F1F1
F1F1F1F1F1F1F1F1F1F1F1F1F1F1F1F1F1F1F1F1F1F1F1F1F1F1F1F1F1F1F1F1F1F1F1F1F1F1F1F1F6T1                                                            R2F0F1F1F1F1F1F1F1F1F1F1F1F1F1F1F1F1F1F1F1F1F1F1F1F1F1F1F1F1F1F1F1F1F1F1F1F1F1F1F1F1F1F1F1F1F1F1F1F1F1F1F1F1F1F1F1F1F1F1F1F1F1F1F1F1F1F1F1F1F1F6R1        R2F0F1F1F1F1F1F1F1F1F1F1F1F6R1                                            R2F1F1F1F1F1F1F1F1F1F1F1F1F1F1F1F1F1F1F1F1F1F1F1F1F1F1F1F1F1F1F1F1F1F1F1F1F1F1F1F1F1F1F1F1F1F1F1F1F1F1F1F1F1F1F1F1F1F1F1
F1F1F1F1F1F1F1F1F1F1F1F1F1F1F1F1F1F1F1F1F1F1F1F1F1F1F1F1F1F1F1F1F1F1F1F1F1F1F1F1F1F6T1          T1T1                                          R2F0F1F1F1F1F1F1F1F1F1F1F1F1F1F1F1F1F1F1F1F1F1F1F1F1F1F1F1F1F1F1F1F1F1F1F1F1F1F1F1F1F1F1F1F1F1F1F1F1F1F1F1F1F1F1F1F1F1F1F1F1F1F1F1F1F1F1F1F1F1F1F1F6R1    R2F0F1F1F1F1F1F1F1F1F1F1F1F1F1F6R1                                        R2F1F1F1F1F1F1F1F1F1F1F1F1F1F1F1F1F1F1F1F1F1F1F1F1F1F1F1F1F1F1F1F1F1F1F1F1F1F1F1F1F1F1F1F1F1F1F1F1F1F1F1F1F1F1F1F1F1F1F1F1
F1F1F1F1F1F1F1F1F1F1F1F1F1F1F1F1F1F1F1F1F1F1F1F1F1F1F1F1F1F1F1F1F1F1F1F1F1F1F1F1F1F1F6T1                                                    R2F0F1F1F1F1F1F1F1F1F1F1F1F1F1F1F1F1F1F1F1F1F1F1F1F1F1F1F1F1F1F1F1F1F1F1F1F1F1F1F1F1F1F1F1F1F1F1F1F1F1F1F1F1F1F1F1F1F1F1F1F1F1F1F1F1F1F1F1F1F1F1F1F1F1F1R1R2F1F1F1F1F1F1F1F1F1F1F1F1F1F1F1T1T1T1T1T1T1T1T1T1T1T1T1T1T1T1T1T1T1T1T1T1T1F1F1F1F1F1F1F1F1F1F1F1F1F1F1F1F1F1F1F1F1F1F1F1F1F1F1F1F1F1F1F1F1F1F1F1F1F1F1F1F1F1F1F1F1F1F1F1F1F1F1F1F1F1F1F1F1F1F1F1F1F1
F1F1F1F1F1F1F1F1F1F1F1F1F1F1F1F1F1F1F1F1F1F1F1F1F1F1F1F1F1F1F1F1F1F1F1F1F1F1F1F1F1F1F1F6T1                    T1T1T1T1T1T1T1T1T1T1T1T1T1T1T1T1F1F1F1F1F1F1F1F1F1F1F1F1F1F1F1F1F1F1F1F1F1F1F1F1F1F1F1F1F1F1F1F1F1F1F1F1F1F1F1F1F1F1F1F1F1F1F1F1F1F1F1F1F1F1F1F1F1F1F1F1F1F1F1F1F1F1F1F1F1F1F1F1F1F1F1F1F1F1F1F1F1F1F1F1F1F1F1F1F1F1F1F1F1F1F1F1F1F1F1F1F1F1F1F1F1F1F1F1F1F1F1F1F1F1F1F1F1F1F1F1F1F1F1F1F1F1F1F1F1F1F1F1F1F1F1F1F1F1F1F1F1F1F1F1F1F1F1F1F1F1F1F1F1F1F1F1F1F1F1F1F1F1F1F1F1F1F1F1F1F1F1F1F1F1F1
F1F1F1F1F1F1F1F1F1F1F1F1F1F1F1F1F1F1F1F1F1F1F1F1F1F1F1F1F1F1F1F1F1F1F1F1F1F1F1F1F1F1F1F1F6T1                T1F0F1F1F1F1F1F1F1F1F1F1F1F1F1F1F1F1F1F1F1F1F1F1F1F1F1F1F1F1F1F1F1F1F1F1F1F1F1F1F1F1F1F1F1F1F1F1F1F1F1F1F1F1F1F1F1F1F1F1F1F1F1F1F1F1F1F1F1F1F1F1F1F1F1F1F1F1F1F1F1F1F1F1F1F1F1F1F1F1F1F1F1F1F1F1F1F1F1F1F1F1F1F1F1F1F1F1F1F1F1F1F1F1F1F1F1F1F1F1F1F1F1F1F1F1F1F1F1F1F1F1F1F1F1F1F1F1F1F1F1F1F1F1F1F1F1F1F1F1F1F1F1F1F1F1F1F1F1F1F1F1F1F1F1F1F1F1F1F1F1F1F1F1F1F1F1F1F1F1F1F1F1F1F1F1F1F1F1F1F1F1
F1F1F1F1F1F1F1F1F1F1F1F1F1F1F1F1F1F1F1F1F1F1F1F1F1F1F1F1F1F1F1F1F1F1F1F1F1F1F1F1F1F1F1F1F1T1T1T1T1T1T1T1T1T1T1F1F1F1F1F1F1F1F1F1F1F1F1F1F1F1F1F1F1F1F1F1F1F1F1F1F1F1F1F1F1F1F1F1F1F1F1F1F1F1F1F1F1F1F1F1F1F1F1F1F1F1F1F1F1F1F1F1F1F1F1F1F1F1F1F1F1F1F1F1F1F1F1F1F1F1F1F1F1F1F1F1F1F1F1F1F1F1F1F1F1F1F1F1F1F1F1F1F1F1F1F1F1F1F1F1F1F1F1F1F1F1F1F1F1F1F1F1F1F1F1F1F1F1F1F1F1F1F1F1F1F1F1F1F1F1F1F1F1F1F1F1F1F1F1F1F1F1F1F1F1F1F1F1F1F1F1F1F1F1F1F1F1F1F1F1F1F1F1F1F1F1F1F1F1F1F1F1F1F1F1F1F1F1F1F1F1F1F1F1F1F1
F1F1F1F1F1F1F1F1F1F1F1F1F1F1F1F1F1F1F1F1F1F1F1F1F1F1F1F1F1F1F1F1F1F1F1F1F1F1F1F1F1F1F1F1F1F1F1F1F1F1F1F1F1F1F1F1F1F1F1F1F1F1F1F1F1F1F1F1F1F1F1F1F1F1F1F1F1F1F1F1F1F1F1F1F1F1F1F1F1F1F1F1F1F1F1F1F1F1F1F1F1F1F1F1F1F1F1F1F1F1F1F1F1F1F1F1F1F1F1F1F1F1F1F1F1F1F1F1F1F1F1F1F1F1F1F1F1F1F1F1F1F1F1F1F1F1F1F1F1F1F1F1F1F1F1F1F1F1F1F1F1F1F1F1F1F1F1F1F1F1F1F1F1F1F1F1F1F1F1F1F1F1F1F1F1F1F1F1F1F1F1F1F1F1F1F1F1F1F1F1F1F1F1F1F1F1F1F1F1F1F1F1F1F1F1F1F1F1F1F1F1F1F1F1F1F1F1F1F1F1F1F1F1F1F1F1F1F1F1F1F1F1F1F1F1F1                                  